R 1024 768

NO ./textures/wall_1.xpm

SO ./textures/wall_2.xpm
WE ./textures/wall_3.xpm

EA ./textures/wall_4.xpm

S ./textures/sprite_1.xpm
F 220,100,0
C 225,30,0


111111111
 
111111111 1111111
1222S2221 1000001
122202221 1111111
122202221
122202221
122202221
122202221
122202221
122202221
122202221
122202221
122202221
122202221
122202221
122202221
100000001
100020001
102000001
100002001
100200001
111111111
 
 111
1001
1111
